##########################
####                     #
#                        #
# T ################  ####
#              #         #
#########      #     T   #
#            # #         #
#           ####         #
#             ####   #####
##            #          #
##            #          #
##        #####          #
##  #     #              #
##                       #
##         #             #
####       #             #
##    ######    #       ##
#     ####     ##        #
#     ###                #
#     ##                 #
#     ######      ##     #
##                       #
##                     T #
##      #                #
##      #              ###
##                    ####
###################Dd#####