######################### #
####                      #
#                         #
# T ################   ####
#              #          #
#########      #     T    #
#            # #          #
#           ####          #
#             ####    #####
##            #           #
##            #           #
##        #####           #
##  #     #               #
##                        #
##         #              #
####       #              #
##    ######    #        ##
#     ####     ##         #
#     ###                 #
#     ##                  #
#     ######      ##      #
##                        #
##                      T #
##      #                 #
##      #               ###
##                     ####
#                         #
###################Dd #####