################################################
#######                                        #
#                                              #
#   T         #################            #####
#                       ######                 #
#########                    #             T   #
#            #               #       #         #
#           ###              #       #         #
#            ######          #########    ######
##             #                     #         #
##             #                     #         #
##       ##          ######          #         #
##        #          #                         #
##                                             #
##           #          #                      #
#####        #         #######                 #
##      ######               #       #         #
#         #####                     ##         #
#                    ####                      #
#                   ##                         #
#       ##############          ###            #
##                                             #
##                                   #      T  #
##              #                    #         #
##              #                   ###        #
##              #                  ####        #
############################################Dd##