######################### #
####                      #
#                         #
#   ################   ####
#              #          #
#########      #          #
#            # #          #
#           ####          #
#    h        ####    #####
##            #           #
##            #           #
##        #####           #
##  #     #          K    #
##                        #
##         #              #
####       #         h    #
##    ######    #        ##
#     ####     ##         #
#     ###                 #
#     ##                  #
#     ######      ##      #
##                        #
##                        #
##      #                 #
##      #               ###
##                     ####
#                         #
###################PP######